able — здатний
about — про
above — вище
accept — визнавати
account — рахунок
across — через
act — діяти
action — дія
activity — діяльність
add — додавати
address — адреса
afraid — наляканий
after — після
afternoon — день
again — знову
against — проти
age — вік
ago — тому
agree — погоджуватися
ahead — попереду
air — повітря
airplane — літак
all — все
allow — дозволяти
almost — майже
alone — тільки
along — вздовж
already — вже
also — також
although — хоча
always — завжди
among — серед
amount — кількість
and — та
angry — сердитий
animal — тварина
another — інший
answer — відповідь
any — будь який
anyone — будь-хто
anything — що-небудь
appear — показуватися
apple — яблуко
approach — підхід
april — квітень
area — площа
arm — озброюватися
arms — зброя
army — армія
around — навколо
arrive — приходити
art — мистецтво
article — стаття
as — як
ask — запитати
at — в
attack — напад
attempt — спроба
attention — увага
august — серпень
autumn — осінь
away — геть
back — назад
bad — поганий
bag — мішок
ball — м'яч
bank — банк
bar — бар
base — база
basic — базовий
bear — ведмідь
beautiful — красивий
because — тому що
become — стати
bed — ліжко
before — до
begin — почати
began — почав
beginning — початок
behind — за
believe — вірити
belong — належить
below — нижче
best — кращий
better — краще
between — між
beyond — за
big — великий
bill — чек
bird — птах
bit — трохи
black — чорний
blood — кров
blow — дути
blue — синій
board — сісти на борт
boat — човен
body — тіло
book — книга
born — народитись
both — обидва
bottle — пляшки
bottom — дно
box — коробка
boy — хлопець
branch — відділення
bread — хліб
break — перерва
broke — зруйнований
breakfast — сніданок
bridge — міст
bright — яскравий
bring — принести
brought — приніс
brother — брат
brown — коричневий
build — будувати
building — будівля
burn — горіти
bus — автобус
business — бізнес
busy — зайнятий
but — але
butter — масло
buy — купувати
bought — куплений
cake — торт
call — називати
can — могти
could — міг
capital — капітал
car — автомобіль
card — картка
care — догляд
carry — нести
case — випадок
cat — кіт
catch — зловити
caught — спійманий
cause — спричиняти
central — центральний
century — століття
certain — певний
certainly — звичайно
chair — крісло
chance — шанс
change — зміна
charge — обвинувачення
cheap — дешевий
cheese — сир
chicken — курка
child — дитина
children — діти
choose — вибирати
church — церква
circle — коло
city — місто
claim — вимагати
class — клас
clean — чистота
clear — ясно
clock — годинник
close — закрити
clothes — одяг
coat — пальто
coffee — кава
cold — холод
college — коледж
colour — колір
come — приходити
came — прийшов
common — загальний
company — компанія
complete — повний
concern — участь
condition — стан
consider — враховувати
continue — продовжувати
control — контроль
cook — готувати
cool — прохолодний
copy — копія
corner — кут
correct — правильний
cost — вартість
count — рахувати
country — країна
course — курс
court — суд
cover — охоплювати
cow — корова
crowd — натовп
cry — плакати
cup — чашка
current — поточний
cut — скоротити
danger — небезпека
dark — темний
date — дата
daughter — дочка
day — день
dead — мертвий
deal — торгувати
dear — шановний
death — смерть
december — грудень
decide — вирішити
decision — рішення
deep — глибоко
degree — ступінь
demand — попит
department — відділ
describe — описувати
desk — стіл
destination — призначення
detail — детально
develop — удосконалювати
die — померти
difference — різниця
different — інший
difficult — важко
dinner — обід
direct — прямий
direction — напрямок
discover — відкривати
discuss — обговорювати
distance — відстань
divide — ділити
do — робити
does — робить
did — зробив
done — зроблено
doctor — лікар
dog — собака
door — двері
doubt — сумнів
down — вниз
draw — тягнути
dress — плаття
drink — пити
drive — їзда
driver — водій
drop — падіння
dry — сухий
during — підчас
duty — борг
each — кожен
ear — вухо
early — рано
earth — земля
east — схід
easy — легко
eat — їсти
edge — край
education — освіта
effect — ефект
effort — зусилля
egg — яйце
eight — вісім
eighteen — вісімнадцять
eighty — вісімдесят
either — або
eleven — одинадцять
else — або
empty — порожній
end — кінець
enemy — ворог
engine — двигун
engineer — інженер
enjoy — користуватися
enough — досить
enter — вводити
especially — особливо
even — навіть
evening — вечір
event — подія
ever — коли-небудь
every — кожен
everybody — всі
everyone — кожен
everything — все
example — наприклад
except — окрім
excuse — вибачати
exercise — вправа
expect — чекати
expensive — коштовний
experience — досвід
explain — пояснювати
eye — око
face — обличчя
fact — факт
factory — завод
fair — справедливий
fall — падіння
family — сім'я
famous — знаменитий
far — далеко
farmer — фермер
fast — швидко
fat — товстий
father — батько
fear — страх
february — лютий
feel — відчуття
felt — відчув
few — декілька
field — поле
fifteen — п'ятнадцять
fifth — п'ятий
fifty — п'ятдесят
fight — боротьба
figure — фігура
fill — заповнювати
film — фільмуватись
final — фінал
find — знайти
fine — чудовий
finger — палець
finish — фініш
fire — вогонь
firm — фірма
first — перший
fish — риба
five — п'ять
flat — плоский
flight — політ
floor — поверх
flower — квітка
fly — політ
follow — слідувати
food — їжа
foot — нога
feet — стопи
for — для
force — сила
foreign — іноземний
forest — ліс
forget — забути
form — форма
forty — сорок
forward — вперед
four — чотири
fourteen — чотирнадцять
free — безкоштовно
fresh — свіжий
friday — п'ятниця
friend — друг
from — від
front — перед
fruit — фрукт
full — повний
further — далі
future — майбутнє
game — гра
garden — сад
general — загальний
get — отримати
girl — дівчина
give — давати
gave — дав
given — даний
glad — радий
glass — скло
go — ходити
went — пішов
god — бог
gold — золото
good — добре
good-bye — допобачення
government — уряд
grass — трава
great — великий
green — зелений
ground — земля
group — група
grow — рости
grew — ріс
guide — гід
gun — гармата
hair — волосся
half — половина
hall — хол
hand — рука
hang — вішати
happen — трапитися
happy — щасливий
hard — важкий
hat — капелюх
he — він
head — голова
health — здоров'я
hear — чути
heard — почутий
heart — серце
heat — тепло
heavy — важкий
help — допомога
her — її
here — тут
high — високий
him — його
his — його
history — історія
hit — удар
hold — утримувати
held — тримається
hole — отвір
holiday — канікули
home — дім
hope — надія
horse — кінь
hospital — лікарня
hot — гарячий
hotel — готель
hour — година
house — дім
how — як
however — проте
human — людина
hundred — сто
hurry — поспішати
husband — чоловік
ice — лід
idea — ідея
if — якщо
ill — зло
important — важливо
in — в
include — містить
increase — збільшення
industry — промисловість
information — інформація
inside — всередині
instead — замість
interest — інтерес
interesting — цікаво
into — в
iron — залізо
island — острів
issue — питання
it — це
its — його
january — січень
job — робота
join — приєднатися
july — липень
jump — стрибок
june — червень
just — просто
keep — тримати
kept — утримуваний
key — ключ
kill — вбити
kind — люб'язний
king — король
kitchen — кухня
knife — ніж
lady — леді
land — земля
language — мова
lack — брак(чогось)
large — великий
last — останній
late — пізній
laugh — сміх
law — закон
lay — класти
lead — вести
leader — лідер
learn — дізнаватися
least — найменш
leave — залишати
left — зліва
leg — нога
less — менше
lesson — урок
let — нехай
let’s — давайте
letter — лист
level — рівень
library — бібліотека
lie — брехати
life — життя
lift — піднімати
light — світло
like — схожий
limit — обмежувати
line — лінія
lip — губа
list — список
listen — слухати
little — маленький
live — жити
local — місцевий
long — довго
look — дивитися
lose — втратити
lot — багато
love — любов
low — низький
lunch — обід
main — основний
make — робити
made — зроблено
many — багато
map — карта
march — березень
mark — знак
market — ринок
material — матеріал
may — могти
maybe — можливо
me — мені
mean — означати
meant — означало
measure — міра
meat — м'ясо
meet — зустрічатися
meeting — зустріч
member — член
message — повідомлення
middle — середина
milk — молоко
million — мільйон
mind — розум
mine — моя
minute — хвилина
miss — відсутній
mistake — помилятися
moment — момент
monday — понеділок
money — гроші
month — місяць
moon — Місяць
more — більше,ще
morning — ранок
most — найбільший
mother — мама
mountain — гора
mouth — рот
move — рухати
much — багато
music — музика
must — повинен
my — мій
name — ім'я
narrow — вузький
national — національний
natural — натуральний
nature — природа
near — поряд
nearly — майже
necessary — необхідно
neck — шия
need — потрібно
neither — жоден
never — ніколи
new — новий
news — новини
newspaper — газета
next — наступний
nice — хороший
night — ніч
nine — дев'ять
nineteen — дев'ятнадцять
ninety — дев'яносто
nobody — ніхто
noise — шум
north — північ
nose — ніс
not — не
note — відмічати
nothing — нічого
notice — замітка
november — листопад
now — зараз
number — число
o’clock — годин
object — об'єкт
october — жовтень
offer — пропозиція
office — офіс
officer — офіцер
official — офіційний
often — часто
oil — олія
old — старий
on — на
once — колись
one — один
only — тільки
open — відкрити
operation — операція
opinion — думка
opposite — навпаки
or — або
orange — помаранчевий
order — порядок
other — інший
our — наш
out — за
over — більше
own — власний
page — сторінка
pain — біль
paint — фарба
pair — пара
paper — папір
park — парк
part — частина
party — партія
pass — прохід
past — минуле
patient — пацієнт
pay — платити
peace — мир
pen — ручка
pencil — олівець
people — народ
perhaps — можливо
period — період
person — людина
pick — збирати
picture — картина
piece — шматок
pink — рожевий
place — поставити
plan — план
plant — рослина
plate — плита
play — гра
please — будь-ласка
point — крапка
police — поліція
political — політичний
poor — бідний
position — позиція
possible — можливий
post — пост
power — сила
practice — практика
prepare — підготовлювати
present — нинішній
press — преса
pretty — гарненький
price — ціна
probably — ймовірно
problem — проблема
produce — виробляти
product — продукт
promise — обіцянка
prove — доводити
provide — постачати
public — громадськість
pull — потягти
pupil — учень
purpose — намір
push — штовхати
put — покласти
quality — якість
quarter — квартал
question — питання
quickly — швидко
quiet — тихий
quite — цілком
race — гонки
radio — радіо
rain — дощ
raise — підвищення
range — діапазон
rate — рівень
rather — вірніше
reach — досягти
read — читати
ready — готовий
really — дійсно
reason — причина
receive — отримувати
recognize — визнати
record — запис
red — червоний
remain — залишатися
remember — пам'ятати
repeat — повторити
reply — відповідь
report — доповідь
represent — представляти
respect — повага
rest — відпочинок
restaurant — ресторан
result — результат
return — повернення
rich — багатий
ride — їздити
right — право
ring — кільце
rise — зростання
river — річка
road — дорога
rock — скеля
roll — рулон
room — кімната
round — круг
rule — правило
run — бігти
ran — побіг
sad — сумний
sale — продаж
same — той
saturday — субота
save — зберегти
say — сказати
said — говорив
school — школа
science — наука
sea — море
season — сезон
seat — сидіння
second — другий
secret — секрет
secretary — секретар
section — розділ
see — бачити
seem — здається
sell — продавати
send — відправити
sent — надісланий
sense — сенс
sentence — речення
separate — окремий
september — вересень
serious — серйозний
serve — служити
service — обслуговування
set — ставити
seven — сім
seventeen — сімнадцять
seventy — сімдесят
several — кілька
shake — трусити
share — частина
sharp — гострий
she — вона
ship — судно
shirt — сорочка
shoe — черевик
shoot — стріляти
shop — магазин
short — короткий
shoulder — плече
show — показувати
shut — зачинятись
side — сторона
sight — погляд
sign — знак
simple — простий
since — з
sing — співати
single — єдиний
sir — пан
sister — сестра
sit — сидіти
sat — сидів
situation — ситуація
six — шість
sixteen — шіснадцять
sixty — шістдесят
size — розмір
skin — шкіра
sky — небо
sleep — спати
slow — повільний
slowly — повільно
small — маленький
smell — запах
smile — посмішка
smoke — дим
snow — сніг
so — отже
social — соціальний
society — суспільство
soft — м'який
solution — рішення
some — деякі
someone — хтось
something — щось
sometimes — іноді
son — син
song — пісня
soon — незабаром
sorry — шкода
sort — сорт
sound — звук
south — південь
space — простір
speak — говорити
special — спеціальний
speed — швидкість
spring — весна
square — прямокутник
stage — сцена
stand — підставка
stood — стояв
star — зірка
start — старт
state — становище
statement — заява
station — певне
stay — залишатися
step — крок
stick — палиця
still — нерухомо
stone — камінь
stop — стоп
store — запасати
story — історія
straight — прямий
strange — незнайомий
street — вулиця
strike — удар
strong — сильний
student — студент
study — вивчення
subject — cуб'єкт
success — успіх
such — такий
suddenly — раптом
sugar — цукор
suggest — пропонувати
suit — костюм
summer — літо
sun — сонце
sunday — неділя
supper — вечеря
supply — постачати
support — підтримка
suppose — припускати
sure — упевнений
surprise — здивування
sweet — солодкий
swim — плавати
system — система
table — стіл
take — брати
took — взяв
talk — розмова
tall — високий
tea — чай
teach — навчати
teacher — вчитель
tear — сльоза
television — телебачення
tell — розповідати
told — сказав
temperature — температура
ten — десять
term — вираз
test — випробування
thank — дякую
their — їх
them — їм
then — тоді
there — там
these — ці
they — вони
thick — товстий
thin — схуднути
thing — річ
think — думати
third — третій
thirteen — тринадцять
thirty — тридцять
this — це
those — ті
though — хочаа
thought — думка
thousand — тисяча
three — три
through — до
throw — кидати
thursday — четвер
tie — краватка
till — грошовий
time — двадцять
to — до
today — сьогодні
together — разом
tomorrow — завтра
too — занадто
tooth — зуб
teeth — зуби
top — верх
touch — дотик
towards — напрямку
town — місто
trade — торгівля
train — тренувати
travel — подорожувати
tree — дерево
trip — подорож
trouble — хвилювання
true — правда
try — спробувати
tuesday — вівторок
turn — поворот
twelve — дванадцять
twenty — двадцять
two — два
type — тип
under — під
understand — розуміти
university — університет
until — доки
up — вгору
upon — на
us — нам
use — використовувати
used — вживаний
usual — звичайний
usually — зазвичай
various — різний
very — дуже
view — вид
village — село
visit — відвідувати
voice — голос
wait — чекати
walk — ходити
wall — стіна
want — хотіти
war — війна
warm — теплий
wash — мити
watch — дивитися
water — вода
wave — хвиля
way — шлях
we — ми
weak — слабкий
wear — носити
weather — погода
wednesday — середа
week — тиждень
welcome — ласкаво
well — добре
west — Захід
what — що
when — коли
where — де
whether — чи
which — котрий
while — поки
white — білий
who — хто
whole — цілий
whom — котрого
whose — чий
why — чому
wide — широкий
wife — дружина
wild — дикий
will — воля
win — вигравати
wind — вітер
window — вікно
winter — зима
wish — бажати
with — з
within — всередині
without — поза
wonderful — чудовий
wood — дерево
word — слово
work — робота
world — світ
worry — хвилювання
would — зробив
write — писати
wrote — написав
wrong — неправильний
year — рік
yellow — жовтий
yes — так
yesterday — вчора
yet — ще
you — ти
young — молодий
your — твій
absence — відсутній
accident — випадковість
active — актиа
actual — актуальний
annual — щоріча
angle — кут
application — програма
attitude — ставлення
average — усереднювати
actor — актор
anger — злий
afterward — пізніше
argue — обстоа
argument — аргумент
badly — погано
background — фон
balance — баланс
borrow — позичати
basis — основа
basket — кошик
bath-room — ванна-кімната
bath — ванна
benefit — користь
being — перебування
bitter — гіркий
businessman — бізнесмен
beauty — краса
border — кордон
broken — зламаний
bicycle — велосипед
button — кнопка
damage — пошкодження
darkness — темрява
document — документ
daily — щоденний
dangerous — небезпечний
data — дані
dirty — брудний
difficulty — труднощі
dictionary — словник
distant — далекий
district — район
drawing — малюнок
double — подвійний
dozen — дюжина
generation — покоління
generally — загалом
gentle — ніжний
gentleman — джентльмен
agency — посереа
agent — користувачем
ancient — стародаа
elephant — слон
excellent — відміна
expert — експерт
explanation — пояснення
export — експорт
extra — додатковий
element — елемент
energy — енергія
anyway — всеодно
anywhere — скрізь
entrance — вхід
envelope — оболонка
estimate — оцінка
evidence — доказ
everywhere — скрізь
factor — фактор
fashion — мода
finally — зрештою
following — наступний
feather — перо
failure — провал
favour — прихильність
favourite — улюблений
furniture — меблі
fairly — справедливо
fellow — колега
feature — особливість
former — колишній
friendly — дружній
frequent — частий
frequently — часто
frighten — лякати
football — футбол
fighting — боротьба
funny — смішний
function — функція
gather — збирати
garage — гараж
golden — золотий
equal — рівний
evil — зло
easily — легко
economic — економічний
camera — фотоапарат
characteristic — характеристика
character — персонаж
captain — капітан
council — рада
castle — замок
comment — коментар
competition — конкуренція
composition — склад
complex — комплекс
conference — конференція
confidence — довіра
contact — контакт
content — зміст
conversation — розмова
cotton — бавовна
curtain — завіса
careful — обережний
carefully — обережно
chemical — хімічний
kilogram — кілограм
kilometre — кілометр
curious — допитливий
classroom — клас
closely — тісно
clever — розумний
clearly — ясно
credit — кредит
creature — створіння
criminal — злочинець
cupboard — шафа
culture — оброблення
comfort — комфорт
comfortable — комфортабельний
couple — об'єднувати
courage — сміливість
customer — споживач
cousin — двоюрідний
audience — аудиторія
author — автор
circumstance — обставина
citizen — громадянин
civil — цивільний
challenge — складне
chapter — розділ
chairman — голова
female — жіночий
freedom — свобода
eastern — східний
bury — поховати
artist — художник
aunt — тітка
band — смуга
bind — зв'язувати
bedroom — спальня
bone — кістка
bell — дзвоник
belt — пояс
bend — вигин
burst — вибух
birth — народження
behave — вести
behaviour — поведінка
belief — переконання
beside — біля
besides — крім
beneath — під
beer — пиво
blind — штора
blame — вина
bowl — кубок
boil — кип'ятити
brain — мозок
brave — хоробрий
breath — дихання
breathe — дихати
brick — цегла
broad — широко
brush — щітка
bush — кущ
bite — укус
dad — тато
director — директор
directly — безпосередньо
domestic — домашній
debt — борг
define — означення
declare — оголошувати
delay — затримка
deliver — виголошувати
deny — заперечувати
depend — залежати
description — опис
discussion — обговорення
discovery — відкриття
despite — не дивлячись на
display — показувати
destroy — руйнувати
division — відділення
desire — бажання
design — дизайн
disease — хвороба
defence — оборона
defeat — поразка
desert — покидати
disappear — зникати
dish — тарілка
due — належний
duck — качка
dull — каламутний
dust — пил
aid — допомога
aim — спрямований
ability — здібність
abroad — за
adopt — переймаа
additional — додаткоа
affair — роман
affect — стосуваа
agreement — угода
according — гармонічний
accuse — звинувачувати
alive — актиа
analysis — анаа
announce — повідомляа
apart — крім
apartment — апартаа
appeal — заклик
appearance — поява
apply — застосоа
appoint — вказувати
appointment — побачення
appropriate — привласнювати
approve — схвалив
approval — схвалення
arrival — прибуття
arise — виникнути
arrange — організувати
arrangement — розташування
arrest — арешт
aside — осторонь
associate — з’єднувати
assistant — помічник
assume — вважати
asleep — сплячий
ashamed — присоромлений
attend — відвідувати
attract — притягати
attractive — привабливий
achieve — досягти
available — доступний
avoid — уникати
admit — визнаваа
advice — порада
advise — радити
advance — просуватись
advantage — перевага
administration — керуваня
association — об'єднання
earn — заробити
fan — вболівальник
file — файл
found — знайдено
fail — невдача
faith — віра
fur — хутро
forgive — прощати
familiar — знайомий
fence — паркан
feed — живлення
fit — підходити
flag — позначка
flame — полум'я
flow — течія
flood — повінь
fork — розгалуження
false — помилковий
fault — помилка
frame — кадр
freeze — заморожувати
fool — дурень
finance — фінанси
financial — фінансовий
fun — розвага
fund — фонд
gas — газ
gain — посилення
gate — ворота
goal — мета
gift — дарунок
grain — зернина
goods — товари
got — отримувати
ease — полегшити
election — вибори
effective — ефективний
equipment — обладнання
electric — електричний
essential — необхідний
escape — втекти
establish — встановлювати
economy — економіка
elect — обирати
electricity — електрика
exact — точний
exactly — точно
examine — вивчати
exist — існувати
existence — існування
expense — витрати
experiment — експеримент
explode — вибухати
explore — досліджувати
express — виражати
extend — поширювати
extent — ступінь
exchange — обмін
employ — використовувати
employer — роботодавець
employee — працівник
employment — зайнятість,
encourage — заохочування
entire — весь
entirely — повністю
environment — довкілля
campaign — компанія
camp — табір
cap — кепка
cash — готівка
calm — спокій
collection — колекція
collect — збирати
command — команда
commercial — комерційний
commission — комісія
committee — комітет
community — співтовариство
connection — зв'язок
connect — з'єднуватися
combine — комбінувати
comparison — порівняння
compare — порівняти
computer — комп'ютер
complain — скаржитися
completely — повністю
conduct — проводити
conclusion — висновок
concerned — причетний
consideration — розгляд
considerable — значний
consist — складатися
contain — містити
contract — скорочуватися
convenient — зручний
curve — крива
cloud — хмара
cloth — тканина
club — клуб
climb — сходження
coal — вугілля
coast — берег
corn — кукурудза
coin — монета
crack — тріскатися
crash — крах
crime — злочин
crop — врожай
cream — вершки
create — створювати
authority — влада
alternative — альтернатива
cell — клітина
cigarette — цигарка
chain — ланцюг
chest — груди
chief — головний
choice — вибір
construction — конструкція
battle — битва
beat — ритм
ad — реклама
airport — аеропорт
item — пункт
obvious — безсумнівний
obviously — очевидно
honour — честь
honest — чесний
journey — подорож
judgement — судження
justice — правосуддя
owner — власник
grandfather — дід
grandmother — баба
granddaughter — онука
grandson — онук
habit — звичка
handle — ручка
hire — найняти
highly — високо
hardly — навряд-чи
illness — хвороба
impact — вплив
indicate — вказувати
influence — вплив
income — прибуток
instance — приклад
institute — інститут
instrument — інструмент
latter — пізніше
likely — ймовірно
leather — шкіра
labour — праця
lower — низький
leading — провідний
legal — легальний
lawyer — адвокат
lucky — щасливий
lovely — гарний
magazine — журнал
manner — спосіб
manage — керувати
manager — керівник
management — керівництво
marriage — шлюб
marry — одружуватися
married — одружений
master — головний
modest — скромний
major — головний
metal — метал
murder — вбивство
mostly — здебільшого
motion — рух
memory — пам'ять
mention — згадувати
method — метод
medium — середній
meaning — значення
merely — просто
movement — рух
neighbourhood — сусідство
needle — голка
nuclear — ядерний
ordinary — звичайний
pattern — шаблон
partly — частково
payment — оплата
plenty — багато
profit — прибуток
proper — належний
properly — правильно
property — власність
pressure — тиск
presence — присутність
previous — попередній
relative — відносний
recent — недавній
recently — недавно
reasonable — розумний
salary — зарплата
satisfy — задовольняти
solid — твердий
seldom — рідко
surface — поверхня
slightly — плавно
suffer — страждати
otherwise — інакше
hearing — слух
healthy — здоровий
image — малюнок
interested — зацікавлений
liquid — рідина
literature — література
medical — медичний
medicine — медицина
rapidly — швидко
railway — залізниця
lonely — самотній
therefore — тому
possibly — можливо
pleasant — приємний
punish — карати
punishment — покарання
rubber — гума
similar — схожий
struggle — боротися
stomach — живіт
silence — тиша
silent — безшумний
threaten — загрожувати
possibility — можливість
identify — ідентифікувати
opportunity — нагода
jam — варення
joke — жарт
joy — радість
joint — з'єднування
juice — сік
judge — суддя
occasion — випадок
occur — відбуватися
obtain — отримувати
observe — спостерігати
owe — заборгувати
guard — охорона
guess — припускати
guest — гість
grant — дарувати
growth — зростання
hide — приховати
height — висота
harm — шкода
hate — ненависть
herself — сама
hers — її
host — господар
hurt — шкода
hill — пагорб
himself — самий
huge — величезний
hunt — полювати
hungry — голодний
leadership — керівництво
imagine — уявляти
immediate — безпосередній
immediately — негайно
initial — початковий
impossible — неможливо
importance — важливість
improve — покращувати
improvement — покращення
indeed — дійсно
industrial — промисловий
inform — повідомити
insurance — страхування
intention — намір
internal — внутрішній
invite — запрошувати
involve — залучити
invent — винаходити
independent — незалежний
individual — окремий
independence — незалежність
institution — інституція
introduce — ввести
introduction — вступ
inch — дюйм
invitation — запрошення
itself — сам
kick — удар
kiss — цілувати
lamp — лампа
loud — гучний
lock — замок
loss — втрати
lost — втрачений
lake — озеро
load — завантажувати
loan — позика
lend — позичати
leaf — листок
lean — нахилятися
lord — володар
luck — удача
mad — божевільний
mass — маса
match — підходити
mail — пошта
male — чоловік
maintain — підтримувати
majority — більшість
meal — їжа
mix — змішувати
mud — болото
might — можливо
knock — стукіт
nail — цвях
nurse — медсестра
know — знати
knew — знав
known — відомий
nephew — племінник
nest — гніздо
knee — коліно
niece — племінниця
none — ніхто
pipe — помпа
passenger — пасажир
pound — удар
path — шлях
pot — каструля
pale — блідий
perform — виконувати
permit — дозволяти
percent — відсоток
persuade — переконувати
particularly — особливо
possess — володіти
performance — продуктивність
pure — чистий
pleased — задоволений
pour — литися
proud — гордий
proposal — пропозиція
prevent — запобігати
proof — доказ
pool — басейн
rice — рис
rail — рейка
row — ряд
role — роль
rope — мотузка
rare — рідкісний
rent — оренда
reduce — зменшувати
refuse — відмовляти
reflect — відображати
regarding — відносно
require — вимагати
requirement — вимога
request — запит
relation — звязок
release — вивільнення
remind — нагадувати
remark — зауваження
remove — вилучити
repair — відновити
replace — замінювати
research — досліджувати,
respond — відповідати
response — відповідь
responsible — відповідальний
reveal — показувати
reserve — заповідник
relationship — відносини
responsibility — відповідальність
root — корінь
roof — дах
rub — терти
rush — квапитися
sock — шкарпетка
solve — розв'язувати
suspect — підозрювати
successful — успішний
soul — душа
seek — прагнути
seed — насіння
severe — важкий
significant — значний
sick — хворий
silk — шовк
sink — потонути
scale — шкала
skirt — спідниця
slide — ковзати
slip — посковзнутися
source — джерело
soil — грунт
spot — місце
speech — промова
split — розкол
spread — поширювати
spoon — ложка
stamp — друк
staff — персонал
stock — акції
stretch — розтягувати
stream — потік
string — рядок
sum — сума
shout — кричати
shade — тінь
shame — ганьба
sheet — лист
shore — берег
tax — оподаткувати
tape — стрічка
taste — смак
tend — доглядати
threat — загроза
ice-cream — морозиво
mile — миля
military — військовий
mineral — мінерал
minister — міністр
mirror — дзеркало
missing — відсутній
model — модель
modern — сучасний
motor — двигун
mouse — миша
mommy — мама
museum — музей
myself — сам
nation — нація
native — рідний
nearby — довколишній
negative — негативний
net — сітка
normal — нормальний
nowhere — ніде
nut — гайка
occupy — займати
ocean — океан
operate — оперувати
organization — організація
organize — організувати
origin — походження
original — оригінал
ours — наш
package — пакет
painting — картина
partner — партнер
pause — пауза
perfect — ідеальний
perfectly — відмінно
personal — особистий
physical — фізичний
pig — свиня
pity — жаль
plain — рівнина
player — гравець
pleasure — задоволення
pocket — кишеня
poem — вірш
poet — поет
poetry — поезія
policeman — поліцейський
policy — політика
politics — політика
popular — популярний
population — населення
positive — позитивний
potato — картопля
potential — потенціал
powerful — потужний
practical — практичний
prefer — віддавати перевагу
president — президент
prime — головний
principle — принцип
print — друк
prison — в'язниця
prisoner — в'язень
prize — приз
process — процес
production — виробництво
profession — професія
progress — прогрес
project — проект
propose — пропонувати
protect — захищати
protection — захист
protest — протест
provision — постачання
publish — публікувати
queen — королева
quietly — спокійно
rabbit — кролик
reaction — реакція
reader — читач
reality — реальність
realize — усвідомити
reference — посилання
register — зареєструвати
regular — регулярний
relief — полегшення
religion — релігія
religious — релігійний
republic — республіка
resource — ресурс
review — огляд
risk — ризик
royal — королівський
safety — безпека
sail — вітрила
salt — сіль
sand — пісок
saving — економія
saw — пилка
scene — сцена
scientific — науковий
scientist — вчений
score — рахунок
screen — екран
search — пошук
security — безпека
series — серія
settle — облаштуватися
settlement — врегулювання
shadow — тінь
sheep — баран
shelf — поличка
shell — оболонка
shift — зсув
shine — блиск
shock — шок
shot — постріл
shower — душ
signal — сигнал
silver — срібло
simply — просто
site — сайт
skill — вміння
smooth — гладенький
snake — змія
soap — мило
soldier — солдат
somebody — хтось
somehow — якось
somewhere — десь
specific — специфічний
spell — вимовляти
spirit — дух
sport — спорт
stair — сходинка
standard — стандарт
steal — вкрасти
steam — пара
steel — сталь
storm — шторм
stranger — незнайомець
strength — міцність
stress — стрес
structure — структура
stupid — дурень
style — стиль
substance — речовина
sudden — раптовий
suggestion — пропозиція
surround — оточувати
swallow — ковтати
swing — гойдання
tail — хвіст
target — ціль
task — завдання
taxi — таксі
team — команда
technical — технічний
terrible — жахливий
text — текст
thanks — дякую
theatre — театр
theirs — їх
themselves — самі
theory — теорія
throat — горло
ticket — квиток
tin — олово
tip — чайові
tired — втомлений
title — назва
tongue — язик
tonight — цієї ночі
tool — інструмент
total — загалом
tough — міцний
tour — тур
tourist — турист
tower — вежа
toy — іграшка
track — трек
training — навчання
transfer — трансфер
translate — перекладати
transport — транспорт
traveller — мандрівник
treat — задоволення
trick — трюк
trust — довіра
truth — правда
tube — трубка
twice — двічі
unable — нездатний
uncle — дядько
underground — підземний
unemployment — безробіття
union — союз
unit — блок
united — об'єднаний
unknown — невідомий
unless — допоки
unusual — незвичайний
upper — верхній
urgent — терміновий
useful — корисний
valley — долина
valuable — цінний
value — значення
variety — різноманітність
vegetable — рослина
version — версія
victory — перемога
violence — насильство
visitor — відвідувач
volume — об’єм
vote — голосування
waiter — офіціант
wake — пробудити
warn — попереджати
warning — попередження
waste — відходи
weapon — зброя
weekend — вихідні
weigh — важити
weight — вага
western — західний
wet — вологий
wheel — колесо
wine — вино
wing — крило
wise — мудрий
wonder — дивина
wooden — дерев’яний
wool — вовна
worker — працівник
working — робота
worst — найгірший
worth — вартий
writer — письменник
yard — ярд
yours — ваш
yourself — сам
youth — молодь
zero — нульовий
absent — відсутній
absolute — абсолютний
absolutely — абсолютно
access — доступ
accordance — відповідно
accordingly — відповідно
accountant — бухгалтер
accurate — точний
ache — біль
achievement — досягнення
acid — кислота
actress — актриса
adjust — налаштовувати
admire — захоплюватися
adult — дорослий
advanced — прогресивний
adventure — пригоди
advertise — рекламувати
agricultural — землеробський
agriculture — сільське
aircraft — літак
airline — авіалінії
alarm — тривога
aloud — уголос
amuse — забавляти
anniversary — річниця
anxiety — тривога
apologize — вибачатися
apparent — видимий
apparently — явно
appreciate — цінувати
arm-chair — крісло
armed — озброєний
arrow — cтрілка
ash — попіл
assembly — збірка
assist — допомога
assistance — допомога
assumption — припущення
assure — запевняти
atmosphere — атмосфера
attribute — атрибут
automatic — автоматичний
avenue — авеню
awake — спить
award — нагорода
awful — величний
bake — випікання
ban — заборона
bare — голий
barely — ледь
bargain — угода
barrel — барель
basketball — баскетбол
bathe — купатися
bay — бухта
beach — берег
bean — квасоля
beard — борода
beast — звір
beef — яловичина
beg — просити
bench — лава
blade — лезо
blanket — ковдра
bloody — закривавлений
boast — хвастощі
bold — зухвалий
bomb — бомба
bother — набридати
breakdown — поломка
brief — короткий
budget — бюджет
buyer — покупець
cabinet — кабінет
cage — клітка
calculate — обчислювати
calculation — обчислення
canal — канал
candidate — кандидат
capable — здатний
career — кар’єра
careless — недбалий
carpet — килим
cart — візок
cave — печера
ceiling — стеля
celebrate — святкувати
ceremony — церемонія
chalk — крейда
channel — канал
chart — чарт
cautious — обережний
cheek — зухвало
cheers — будьмо!
childhood — дитинство
chin — підборіддя
chip — скибочка
chocolate — шоколад
cinema — кіно
circus — цирк
clay — глина
climate — клімат
closed — закритий
code — код
collapse — колапс
collar — комір
colleague — колега
collector — колектор
colony — колонія
column — колонка
comb — гребінь
coming — наближення
commander — командир
commerce — торгівля
commit — вчиняти
commitment — зобов’язання
companion — компаньйон
compete — конкурувати
complaint — скарга
completion — завершення
complicated — складний
component — компонент
compose — складати
compound — сполука
concentrate — концентрат
concentration — концентрація
concept — концепція
concert — концерт
conclude — закінчувати
confident — впевнений
confirm — підтверджувати
conflict — конфлікт
confuse — збентеження
congratulate — поздоровляти
congratulation — поздоровлення
congress — конгрес
conscience — совість
conscious — свідомий
conservative — консервативний
consistent — послідовний
constant — постійний
construct — споруджувати
consult — консультуватися
consumer — споживач
container — контейнер
context — контекст
continent — континент
continuity — безперервність
continuous — безперервний
contrary — навпаки
contrast — контраст
contribution — внесок
convert — конвертувати
convince — переконувати
copper — мідь
corporation — корпорація
correctly — правильно
correspond — відповідати
correspondence — відповідність
cottage — котедж
cough — кашель
counter — лічильник
creation — створення
crew — команда
crisis — криза
critic — критик
criticism — критика
crowded — переповнений
crown — корона
cruel — жорстокий
crush — роздавлювання
cultural — культурний
cure — лікування
currency — валюта
currently — на даний момент
custom — клієнти
customs — мито
cycle — цикл
dancer — танцюрист
dare — наважуватися
deaf — глухий
dealer — дилер
debate — дебати
decade — десятиліття
declaration — декларація
decline — падіння
decrease — зменшення
deeply — глибоко
deer — олень
defend — захищати
definition — визначення
delicate — делікатний
delight — захоплення
delivery — доставка
demonstrate — демонструвати
demonstration — демонстрація
dependent — залежний
depth — глибина
derive — користь
descend — спускатися
deserve — заслуговувати
destruction — зруйнування
detailed — детальний
determination — встановлення
devil — диявол
devote — присвячувати
diamond — діамант
differ — відрізнятися
disagree — не погоджуватися
disappointment — розчарування
discipline — дисципліна
dislike — неприхильність
dismiss — звільняти
dispute — спорити
distinct — ясний
distinction — відмінність
distinguish — розрізняти
distribute — розподіляти
distribution — розподіл
disturb — турбувати
dive — занурення
dot — крапка
downstairs — внизу
drag — тягти
driving — катання
drown — тонути
drug — ліки
drum — барабан
drunk — п’яний
dusty — запилений
eager — нетерплячий
edition — версія
editor — редактор
educate — навчати
educational — освітній
effectively — ефективно
efficiency — ефективність
efficient — ефективний
elderly — літній
eliminate — знищувати
emergency — аварія
emphasis — наголос
emphasize — наголошувати
empire — імперія
engage — наймати
enormous — величезний
entertain — забавляти
entertainment — розваги
entry — вхід
error — помилка
establishment — організація
estate — майно
evaluate — оцінювати
eventually — зрештою
evident — очевидний
excess — надмірність
excessive — надмірний
excite — збуджувати
excitement — збудження
exciting — збуджуючий
executive — виконавчий
exhibition — виставка
expand — розширювати
expansion — розширення
expectation — очікування
experienced — досвідчений
explosion — вибух
expose — розкривати
extension — розширення
extensive — обширний
external — зовнішній
extraordinary — екстраординарний
extreme — крайність
fade — блякнути
faint — слабкий
faithful — вірний
fancy — фантазія
fasten — скріплювати
fate — доля
favourable — сприятливий
federal — федеральний
fee — плата
fighter — боєць
fixed — фіксований
flash — спалах
flour — борошно
focus — фокус
fog — туман
fold — складати
fond — основа
foolish — дурний
forbid — заборонити
foreigner — іноземець
forever — назавжди
formal — формальний
formula — формула
fortunately — на щастя
fortune — фортуна
frequency — частота
friendship — дружба
frozen — замерзлий
fry — смажити
fuel — паливо
fundamental — фундаментальний
funeral — поховання
furnish — оздоблення
furthermore — крім того
gallery — галерея
gap — діра
generate — створювати
generous — щедрий
gently — злегка
giant — гігант
girlfriend — подружка
glance — виблискування
glove — рукавичка
goat — козел
govern — управляти
governor — губернатор
grace — прикрашати
grade — ступінь
gradually — поступово
grammar — граматика
grand — великий
grandchild — онук
grateful — вдячний
grave — могила
growing — зростання
grown-up — дорослий
guarantee — гарантія
guilty — винний
hammer — молоток
handsome — щедрий
happiness — щастя
harbour — гавань
harvest — збирати
headache — головний біль
heating — опалення
heaven — рай
heavily — сильно
heel — п’ятка
hell — пекло
helpful — корисний
hen — курка
hero — герой
hesitate — вагатися
hi — привіт
highlight — яскравий
highway — шосе
historic — історичний
historical — історичний
holder — тримач
holy — святий
homework — домашня робота
honey — мед
honourable — почесний
hook — гак
horseback — спина
household — домогосподарство
housewife — домогосподарка
hunger — голод
hunter — мисливець
hut — хатина
ideal — ідеал
identity — ідентичність
idle — байдикувати
ignore — ігнорувати
illegal — незаконний
illustrate — ілюструвати
imagination — уява
import — імпорт
impose — нав’язувати
impression — враження
incident — інцидент
index — індекс
indication — індикація
injure — ранити
ink — чорнило
inner — внутрішній
insist — наполегливо
instant — мить
instruction — інструкція
intelligence — інтелект
intelligent — розумний
interfere — втручатися
interpret — тлумачити
interpretation — інтерпретація
interrupt — переривання
interval — інтервал
interview — інтерв’ю
invention — винахід
investigate — розслідувати
involved — вплутати
jacket — куртка
jaw — щелепа
jewel — коштовність
journal — журнал
journalist — журналіст
junior — молодший
justify — виправдання
keeper — хранитель
kingdom — королівство
knot — вузол
label — етикетка
ladder — драбина
landing — висадка
landlord — землевласник
lately — нещодавно
laughter — сміх
launch — запуск
layer — шар
league — ліга
learning — вивчення
lecture — лекція
lemon — лимон
liberal — ліберал
liberty — свобода
limited — обмеженою
lion — лев
literary — літературний
locate — розмістити
location — розташування
loyal — лояльний
luggage — багаж
lung — легеня
magic — магія
maintenance — підтримання
manufacturer — виробник
marketing — маркетинг
maximum — максимум
meanwhile — тим часом
measurement — вимірювання
melt — плавити
membership — членство
mental — ментальний
merchant — торговець
midnight — опівночі
mild — помірний
mill — млин
miner — шахтар
minimum — мінімум
ministry — міністерство
minority — меншість
mixed — змішений
mixture — суміш
moderate — стриманий
monitor — монітор
monkey — мавпа
mood — настрій
moral — моральний
moreover — крім того
motorcycle — мотоцикл
movie — фільм
moving — зворушливий
multiply — помножити
muscle — мускул
musician — музикант
mysterious — таємничий
mystery — таємниця
nationality — національність
naturally — природно
necessarily — обов’язково
necessity — необхідність
nerve — нерв
nervous — нервовий
network — мережа
nevertheless — все-таки
noble — шляхетний
nod — кивок
noisy — шумний
normally — зазвичай
notion — ідея
noun — іменник
novel — новітній
nowadays — сьогодення
numerous — числений
obey — підкорятися
objection — заперечення
objective — об’єктив
observation — спостереження
observer — спостерігач
occasionally — зрідка
occupation — зайнятість
odd — надлишок
offence — образи
offend — ображати
operator — оператор
oppose — проти
opposition — опозиція
option — опція
organ — установа
outcome — наслідок
outline — контур
outstanding — визначний
overall — загальний
overcome — подолати
ownership — власність
pace — темп
pad — килимок
painful — болючий
painter — художник
palace — палац
pardon — прощати
parking — паркінг
part-time — неповний день
participate — брати участь
participation — участь
particle — маленька
patience — терпіння
peaceful — тихий
permission — дозвіл
personally — особисто
pet — домашня тварина
petrol — бензин
phase — фаза
phenomenon — феномен
philosophy — філософія
phrase — фраза
pile — стовп
pilot — пілот
planet — планета
planning — планування
plastic — пластик
platform — платформа
plus — плюс
pointing — заточення
pole — стовп
polite — ввічливий
politician — політик
port — порт
possession — володіння
postal — поштовий
postman — листоноша
postpone — відкладати
poverty — бідність
powder — порошок
practise — практикуватися
pray — молитися
prayer — молитва
precious — дорогий
predict — прогнозувати
prepared — оброблений
presidential — президентський
pretend — претендувати
previously — попередньо
pride — гордість
prince — принц
probability — ймовірність
probable — ймовірний
proceed — продовжувати
productive — продуктивний
professor — професор
progressive — прогресивний
promote — просувати
prompt — підказка
pronounce — вимовляти
pronunciation — вимова
proportion — пропорція
prospect — перспектива
provided — забезпечений
publication — публікація
publicity — публічність
pump — нагнітати
purchase — покупка
purple — пурпурний
pursue — гнатися
puzzle — пазл
qualification — кваліфікація
quarrel — сваритися
radical — радикальний
raincoat — плащ
rainy — дощовий
rapid — швидкісний
rarely — рідко
rat — щур
raw — сирий
ray — промінь
react — реагувати
reading — читання
realistic — реалістичний
receipt — квитанція
receiver — одержувач
recognition — визнання
recommend — рекомендувати
recommendation — рекомендація
recover — відновлювати
reduction — скорочення
reform — реформа
refusal — відмова
regime — режим
regional — регіональний
regret — шкодувати
regulation — регулювання
reject — відторгати
related — пов’язаний
relatively — щодо
relax — релаксувати
relevant — релевантний
reliable — надійний
relieve — полегшувати
rely — покладатися
remaining — решта
remains — залишки
remarkable — чудовий
reporter — репортер
reputation — репутація
rescue — порятунок
reservation — резервування
resident — резидент
resign — йти у відставку
resist — чинити опір
resistance — опір
resolve — рішення
restore — відновити
restrict — обежувати
restriction — обмеження
retain — утримувати
retire — йти
revolution — революція
reward — винагорода
rid — позбавлятись
rival — конкурент
rob — грабувати
rose — троянда
route — маршрут
royalty — королівська
rude — грубий
ruin — руйнування
sacrifice — жертва
sailor — моряк
sample — зразок
satisfaction — задоволення
sauce — соус
scatter — розсіювати
schedule — розпорядок
scheme — схема
scissors — ножиці
scratch — подряпина
screw — вкручувати
seaside — морський
sector — сектор
secure — надійний
seize — захопити
select — вибрати
selection — вибір
senior — старший
sensible — розумний
sensitive — чутливий
sequence — послідовність
seriously — серйозно
session — сесія
setting — установка
sexual — сексуальне
sharply — різко
shave — гоління
shelter — укритття
shortage — нестача
shortly — незабаром
signature — підпис
significance — значущість
singer — співак
slave — раб
slope — нахил
snowy — покритий снігом
so-called — так званий
softly — м’яко
sometime — коли-небудь
soup — суп
sour — кислий
spare — запасний
specialist — спеціаліст
spelling — правопис
spin — струмінь
splendid — чудовий
spoil — псувати
stable — стайня
stare — вдивлятися
status — статус
steep — занурюватися
stem — затримувати
stocking — панчоха
storage — зберігання
stove — пічка
straw — солома
strengthen — зміцнювати
strict — суворий
striking — вражаючий
strip — смужка
strongly — сильно
sufficient — достатній
suitable — придатний
suitcase — невелика валіза
sunlight — сонячне
sunny — сонячний
surely — безсумнівно
surroundings — околиці
survey — опитування
survive — пережити
suspicion — підозра
suspicious — підозріливий
swear — матюкатись
sweat — піт
swimming — плавання
switch — змінювати
sword — меч
symbol — символ
sympathy — симпатія
tailor — кравець
tank — танк
tap — стукати
teaching — викладання
technique — техніка
technology — технологія
temper — стримуватися
temple — храм
temporary — тимчасовий
tendency — тенденція
tender — делікатний
tennis — теніс
tension — напруга
territory — територія
textbook — підручник
thief — злодій
thinking — думаючий
thirsty — спраглий
thread — нитка
thumb — великий
thunder — грім
tide — приплив
tire — шина
tobacco — тютюн
topic — тема
totally — загалом
towel — рушник
trace — слід
traditional — традиційний
trainer — тренер
translation — переклад
trap — пастка
treasure — скарб
treaty — договір
trend — тенденція
tribe — плем’я
troop — група
trousers — брюки
truck — вантажівка
truly — правдиво
trunk — стовбур
tune — мелодія
twist — кручення
typical — типовий
ugly — потворний
uncomfortable — незручний
undermine — підривати
undertake — брати на себе
unemployed — безробітний
unexpected — неочікуваний
unfortunately — нажаль
unhappy — нещасливий
uniform — форма
unite — об’єднувати
unity — єдність
universe — всесвіт
unlikely — навряд
unpleasant — неприємний
upset — засмучений
upstairs — нагорі
useless — безкорисний
user — користувач
variable — величина
variation — зміна
vast — величезний
vehicle — автомобіль
verb — дієслово
verse — вірш
vessel — судно
victim — жертва
vision — бачення
vital — життєвий
voter — виборець
voyage — подорож
waitress — офіціантка
weakness — слабкість
weekly — щотижневик
well-known — добре відомий
wheat — пшениця
whistle — свист
widely — широко
widespread — поширений
widow — вдова
winner — переможець
wipe — витирати
wisdom — мудрість
withdraw — забирати
wolf — вовк
wrist — зап'ясток
writing — писання
written — написаний
yeah — так
pose — поза
plane — літак
shape — форма
dance — танець
vary — варіювати
length — довжина
region — регіон
fraction — частинка
tiny — маленький
lone — відлюдний
mount — монтувати
melody — мелодія
clothe — одягати
baby — крихітка
cent — цен
wire — дріт
paragraph — пункт
decimal — десятковий
molecule — молекула
insect — комаха
atom — атом
plural — множина
oxygen — кисень
magnet — магніт
suffix — суфікс
bat — кажан
dream — мрія
dollar — долар
triangle — трикутник
favor — послуга
segment — сегмент
populate — заселяти
chick — курча
subtract — віднімати
look after — наглядати  
look for — шукати  
look forward to — з нетерпінням чекати  
look up — шукати  
look out — будь обережний  
give up — здаватися  
give in — поступатися  
give away — роздавати, дарувати  
give back — повертати  
take off — злітати, знімати одяг  
take out — виймати, витягувати 
take over — перебрати контроль  
take up — почати займатися  
take after — бути схожим на  
put off — відкладати  
put on — надягати   
put up with — миритися з чимось  
put down — принижувати  
come in — заходити  
come out — виходити  
come back — повертатися  
come up with — вигадати, запропонувати  
come across — випадково натрапити
go out — виходити  
go on — продовжувати  
go back — повертатися  
go over — переглядати, повторювати  
get up — вставати  
get off — виходити  
get on — заходити  
get over — пережити, оговтатися  
get back — повертатися  
get in — заходити, проникати  
turn on — вмикати 
turn off — вимикати  
turn up — з'явитися, прийти  
turn down — відхилити, зменшити  
break down — зламатися  
break up — розійтися  
break in — вламуватись  
break out — раптово початися   
bring up — згадати, підняти тему  
bring back — повертати 
run out of — закінчитися (про запаси)  
run into — випадково зустріти 
run away — втекти  
call off — скасувати  
call back — передзвонити  
call out — викликати, вигукнути  
check in — зареєструватися  
check out — виписатися (з готелю)  
set up — засновувати, організовувати  
show up — з'явитися  
slow down — сповільнюватися  
speed up — прискорюватися  
fill in — заповнювати (форму)  
fill out — заповнювати
carry on — продовжувати  
hold on — зачекати, триматися  
hang out — проводити час, зависати  
hang up — покласти слухавку  
wake up — прокидатися  
watch out — остерігатися  
work out — тренуватись
back up — підтримувати, резервувати  
be over — завершитися  
blow up — вибухнути  
break into — вламатися  
bring in — залучати  
brush up on — освіжити знання  
bump into — випадково зустріти  
carry out — виконувати  
catch up — надолужувати  
check on — перевірити, навідатися  
come down with — захворіти  
come along — супроводжувати  
cut off — відрізати, припинити подачу  
cut down on — скоротити  
do over — переробити  
do up — застібати, ремонтувати  
drop by — заскочити ненадовго
drop off — висадити, задрімати  
end up — врешті-решт опинитися  
fall apart — розвалюватися    
figure out — з’ясувати, зрозуміти  
find out — дізнатися  
get along — ладнати    
get through — додзвонитися, пройти через  
give out — закінчитися, роздавати  
go along with — погоджуватися    
hand out — роздавати  
head out — вирушати  
hold back — стримувати  
keep on — продовжувати  
keep up with — йти в ногу з  
kick off — починати  
leave out — пропускати  
let down — підвести  
let in — впускати  
look back — озиратися в минуле  
make out — розібрати, зрозуміти  
make up — вигадати, помиритися  
move in — переїжджати  
move out — виїжджати  
pass away — померти  
pass out — знепритомніти  
pay back — повертати гроші  
pick up — підбирати, забирати  
point out — вказувати  
pull over — з’їхати на узбіччя  
put aside — відкласти  
read over — перечитати  
rip off — обдурити на гроші    
run over — переїхати (когось/щось)  
set off — вирушати в дорогу  
show off — вихвалятися  
shut down — закрити, припинити роботу  
sign up — записатися  
stand by — підтримувати, бути напоготові  
stand out — виділятися  
stick to — дотримуватися  
take in — зрозуміти, ввібрати  
tear up — розірвати (на шматки)  
think over — обдумати  
throw away — викидати  
try on — приміряти  
turn around — розвертатися
turned out - виявилось  
wake up to — усвідомити  
watch over — приглядати  
wear out — зношуватися  
write down — записати  
zoom in — збільшити зображення